###################
#*________________#
#_#_#_#_#_#_#_#_#_#
#_________________#
#_#_#_#_#_#_#_#_#_#
#_________________#
#_#_#_#_#_#_#_#_#_#
#_________________#
#_#_#_#_#_#_#_#_#_#
#_________________#
#_#_#_#_#_#_#_#_#_#
#_________________#
#_#_#_#_#_#_#_#_#_#
#_________________#
#_#_#_#_#_#_#_#_#_#
#_________________#
###################